NO ./textures/wall1.xpm
WE ./textures/wall3.xpm
EA ./textures/wall4.xpm

C 0,0,300

F 0,800,800

SO ./textures/wall2.xpm



       1111111111111111111 1111111
11111111100000000011000001 1000001
10110000011100000000000011 1111111
100100000000000000000000111111111
111111111011000001110000000000001
100000000011000001110111111111111
11110111111111011100000010001
11110111111111011101010010001
11000000110101011100000010001
10000000000W00000000000010001
10000000000000001101010010001
11000001110101011111011110001
11110101 1110101 101111010001
11111111 1111111 1111111111111


111
101
111

